100 30 40 bg0.png
................OO......................................................................................................................................................................................
................OO......................................................................................................................................................................................
................OO......................................................................................................................................................................................
................OO......................................................................................................................................................................................
................OO......................................................................................................................................................................................
................OO......................................................................................................................................................................................
................BR......................................................................................................................................................................................
........................................................................................................................................................................................................
........................................................................................................................................................................................................
........................................................................................................................................................................................................
................OO......................................................................................................................................................................................
................BR......................................................................................................................................................................................
........................................................................................................................................................................................................
........................................................................................................................................................................................................
........................................................................................................................................................................................................
..............OOOOOO....................................................................................................................................................................................
..............BRBRBR....................................................................................................................................................................................
........................................................................................................................................................................................................
............................................................................OO......OO......OO......OO..................................................................................................
............................................................................BR......BR......BR......BR..................................................................................................
............OOOOOOOOOO..................................................................................................................................................................................
............BRBRBRBRBR..............OOOOOOOO............................................................................................................................................................
....................................................................WB......................................WB..........................................................................................
....................................................................WBWBWBWBWBWBWBWBWBWBWBWBWBWBWBWBWBWBWBWBWB..........................................................................................
........................................................................................................................................................................................................
....ST..................................................................................................................................................................................................
G1G1G1G1G1G1G1G1G1G1G1G1G1G1G1G2................G0G1G1G1G1G1G2..........................................................................................................................................
G4G4G4G4G4G4G4G4G4G4G4G4G4G4G4G5................G3G4G4G4G4G4G5..........................................................................................................................................
G4G4G4G4G4G4G4G4G4G4G4G4G4G4G4G5................G3G4G4G4G4G4G5..........................................................................................................................................
G4G4G4G4G4G4G4G4G4G4G4G4G4G4G4G5................G3G4G4G4G4G4G5..........................................................................................................................................
