50 36 48 bg0.png
....................................................................................................
....................................................................................................
..WBWBWBWBWBWBWBWBWBWBWBWBWBWBWBWBWBWBWBWBWB........WBWBWBWBWBWBWBWBWBWBWBWBWBWBWBWBWBWBWBWBWB..WBWB
..................................................WB........................................WB......
................................................WB..........................................WBWBWB..
..............................................WB....................................................
............................................WB......................................................
..........................................WB........................................................
........................................WB..........................................................
......................................WB............................................................
....................................WB..............................................................
..................................WB................................................................
................................WB..................................................................
..............................WB....................................................................
............................WB......................................................................
..........................WB........................................................................
........................WB..........................................................................
................................................................................................OO..
G0G1G1G1G2R0R1R1R1R2WB........................................................................WBOO..
G3G9G7GAG5R3R4R7R4R5WBWB........................................................................OO..
G3G5..G3G5R3R5..R3R5WBWBWB....................................................................WBOO..
G3GBG1GCG5R3R4R1R4R5WBWBWBWB........ST......................................................WB..OO..
G6G7G7G7G8R6R7R7R7R8WBWBWBWBWB..BRBRBRBRBRBRBRBR............................................WBWBOO..
............................................................................................WB..OO..
WBWBWBWBWBWBWBWBWB..WBWBWBWBWBWBWBWBWBWBWBWBWBWBWBWBWBWBWBWBWBWBWBWBWBWBWBWBWBWBWBWBWBWBWBWBWBWBOO..
WBOO............................................................................................OO..
WBWBOOWBOOWBOOWBOOWBOOWBOOWBOOWBOOWBOOWBOOWBOOWBOOWBOOWBOOWBOOWBOOWBOOWBOOWBOOWBOOWBOOWBOOWBOOWBOO..
WB....WB..WB..WB..WB..........WB..WB......WB....................................................OO..
WB....WB..........WBWBWBWBWBWBWB......WBWBWB..................................................WBOO..
WB..WBWBWBWBWBWBWBWBWB..WBWBWB....WB..WB........................................................OO..
WB....WB..WBWBWBWB..............WBWBWBWB..........OOOOOOOO....................................WBOO..
WB....WB....WBWBWB..WB..WBWBWBWBWB..............OO........OO....................................OO..
WBWB......WBWB................................OO............OO..................................OO..
WBWB..WB..WBWB..WBWBWB......................OO................OO................................OO..
WBWB......................................OO....................OO..............................WB..
WBWBWBWBWBWBWBWBWBWBWBWBWBWBWBWBWBWBWBWBWBWBWBWBWBWBWBWBWBWBWBWBWBWBWBWBWBWBWBWBWBWBWBWBWBWBWBWBWB..
